· · · | · · · · · · · · · · · | · · ● · · ● · | · · · · · · ● 
· · · · ● · · · · ● · · ● · · ● · · · · · · · · · · · · ● ● · 
· · · | · · · · · | · · · · · · · | · · · · · | · | · | · · · 
· · | | · | | | · | | | | | | | | | · | | | | | · | ● | · · | 
· · · ● ● · · | · ● · · · ● · · · | · · · · · | · | · | · · · 
● · | | | | · | | | | | | | ● | · | ● | | | | | · | · | | · · 
· · · | · · ● | · · · ● · | · | · | · | · · · | · | · | · · · 
| · · | | | | | · | | | · | | | · | · | · | · | · | · | | · | 
· · · · · · · | ● | · | · · · | · | · | · | · · · | · · · ● · 
· · | | | | · | · | · | | | · | · | | | · | | | | | | | | · · 
· · · · · | · | ● | · · · | · | · · · · · | · · · · · · ● · · 
· · · | | | ● | · | | | · | · | | | · | | | | | · | | | | · · 
· · · | ● ● · | · · · | · · · · · | · | · · · | · | ● · · ● · 
· · | | · | | | | | ● | | | | | · | · | · | 🟢 | · | · | | · | 
· · · | ● ● · · · | · · · | · | · | · · · | · · · | · · · · · 
| · · | | | | | · | · | · | · | · | | | | | · | | | | | · · · 
· · · · · | · · · | · | · | · · · | · | · · · | · · · | · · · 
· · | | | | · | | | | | · | · | | | · | · | | | · | · | | ● · 
· · · · ● · · | · · ● · · | ● | · · · · ● · · | · | ● · · · · 
· · | | | | | | · | | | | | · | | | ● | | | | | ● | | | | · · 
· ● · · · · · · · | · ● · | · · · | · | · · · | · | · · · · · 
· · · | | | | | | | ● | | | | | · | · | · | · | · | · | | · | 
· · · | · | ● · · · · | · · · | · | · | · | · · · | ● · · · · 
· · · | · | · | | | · | · | · | ● | | | · | | | | | | | | · ● 
· · · | · · · · · | · · · | · · · · · · · | · · · · · · · · ● 
● · | | | | | | | | | | | | | | | | | | | | | | | | | | | ● · 
· · · ● · · · · · · · · · · · · · · · · · · · · · · ● · · · · 
| | | | | | | | | | | | | | | | | | | | | | | | | | | | | | |
