█ █ █ █ █ █ █ █ █ █ █ █ █ █ █ █ █ █ █ █ █ █ █ █ █ █ █ █ █ █ █ 
█ ● █ · █ · █ · █ · █ · █ · █ · █ · █ · █ · █ · █ · █ · █ ● █ 
█ · █ · █ █ █ █ █ █ █ █ █ █ █ █ █ █ █ █ █ █ █ █ █ █ █ █ █ █ █ 
█ · · · · · █ · █ ● █ · █ · █ ● █ · █ · █ · █ · █ · █ · █ · █ 
█ █ █ · █ · █ █ █ █ █ █ █ █ █ █ █ █ █ █ █ █ █ █ █ █ █ █ █ █ █ 
█ · █ · · · · · █ · █ · █ · █ · █ · █ · █ · █ · █ · █ · █ · █ 
█ █ █ █ █ · █ · █ █ █ █ █ █ █ █ █ █ █ █ █ █ █ █ █ █ █ █ █ █ █ 
█ ● █ · █ · · ● · · █ · █ · █ ● █ · █ · █ · █ · █ · █ · █ · █ 
█ █ █ █ █ █ █ · █ · █ █ █ █ █ █ █ █ █ █ █ █ █ █ █ █ █ █ █ █ █ 
█ · █ · █ · █ · · ● · · █ · █ ● █ ● █ ● █ ● █ · █ · █ · █ · █ 
█ █ █ █ █ █ █ █ █ · █ · █ █ █ █ █ █ █ █ █ █ █ █ █ █ █ █ █ █ █ 
█ · █ · █ · █ · █ ● · · · · █ · █ · █ · █ · █ · █ ● █ · █ · █ 
█ █ █ █ █ █ █ █ █ █ █ ● █ · █ █ █ █ █ █ █ █ █ █ █ █ █ █ █ █ █ 
█ · █ · █ · █ · █ · █ · · ● · · █ · █ · █ · 🟢 ● █ · █ · █ ● █ 
█ █ █ █ █ █ █ █ █ █ █ █ █ · █ · █ █ █ █ █ █ █ █ █ █ █ █ █ █ █ 
█ · █ · █ · █ · █ · █ ● █ · · · · · █ · █ · █ · █ · █ · █ · █ 
█ █ █ █ █ █ █ █ █ █ █ █ █ █ █ · █ · █ █ █ █ █ █ █ █ █ █ █ █ █ 
█ ● █ · █ · █ · █ · █ ● █ · █ · · · · · █ · █ · █ · █ · █ ● █ 
█ █ █ █ █ █ █ █ █ █ █ █ █ █ █ █ █ ● █ · █ █ █ █ █ █ █ █ █ █ █ 
█ · █ · █ · █ · █ · █ · █ · █ · █ · · · · · █ ● █ · █ · █ · █ 
█ █ █ █ █ █ █ █ █ █ █ █ █ █ █ █ █ █ █ · █ ● █ █ █ █ █ █ █ █ █ 
█ · █ · █ · █ · █ · █ · █ · █ ● █ · █ · · · · · █ · █ · █ · █ 
█ █ █ █ █ █ █ █ █ █ █ █ █ █ █ █ █ █ █ █ █ · █ · █ █ █ █ █ █ █ 
█ · █ · █ · █ · █ · █ · █ · █ · █ · █ · █ · · · · · █ ● █ · █ 
█ █ █ █ █ █ █ █ █ █ █ █ █ █ █ █ █ █ █ █ █ █ █ █ █ · █ █ █ █ █ 
█ · █ · █ · █ · █ · █ · █ ● █ ● █ · █ · █ · █ · · · · · █ · █ 
█ █ █ █ █ █ █ █ █ █ █ █ █ █ █ █ █ █ █ █ █ █ █ █ █ · █ · █ █ █ 
█ ● █ · █ · █ · █ · █ · █ · █ · █ · █ · █ · █ · █ · ● · · · █
