|  |  |  |  |  |  |  |  |  |  |  |  |  |  |  |  |  |  |  |  |  |  |  |  |  |  |  |  |  |  |  
|  |  |  |  |  |  |  |  |  |  |  |  |  |  |  |  |  |  |  |  |  |  |  |  |  |  |  |  |  |  |  
|  |  |  |  |  |  |  |  |  |  |  |  |  |  |  |  |  |  |  |  |  |  |  |  |  |  |  |  |  |  |  
|  |  |  |  |  |  |  |  |  |  |  |  |  |  |  |  |  |  |  |  |  |  |  |  |  |  |  |  |  |  |  
|  |  |  |  |  |  |  |  |  |  |  |  |  |  |  |  |  |  |  |  |  |  |  |  |  |  |  |  |  |  |  
|  |  |  |  |  |  |  |  |  |  |  |  |  |  |  |  |  |  |  |  |  |  |  |  |  |  |  |  |  |  |  
|  |  |  |  |  |  |  |  |  |  |  |  |  |  |  |  |  |  |  |  |  |  |  |  |  |  |  |  |  |  |  
|  |  |  |  |  |  |  |  |  |  |  |  |  |  |  |  |  |  |  |  |  |  |  |  |  |  |  |  |  |  |  
|  |  |  |  |  |  |  |  |  |  |  |  |  |  |  |  |  |  |  |  |  |  |  |  |  |  |  |  |  |  |  
|  |  |  |  |  |  |  |  |  |  |  |  |  |  |  |  |  |  ·  ·  ·  ·  |  |  |  |  |  |  |  |  |  
|  |  |  |  |  |  |  |  |  |  |  |  |  |  |  |  |  |  ·  |  |  ·  |  |  |  |  |  |  |  |  |  
|  |  |  |  |  |  |  |  |  |  |  |  |  |  |  |  |  |  ·  |  |  ·  |  |  |  |  |  |  |  |  |  
|  |  |  |  |  |  |  |  |  |  |  |  |  |  |  |  |  |  ·  ·  ·  ·  |  |  |  |  |  |  |  |  |  
|  |  |  |  |  |  |  |  |  |  |  |  |  |  |  ·  ·  ·  ·  ·  ·  ·  🟣 |  |  |  |  |  |  |  |  
|  |  |  |  |  |  |  |  |  |  |  |  |  |  |  ·  |  |  |  |  |  ·  |  |  |  |  |  |  |  |  |  
|  |  |  |  |  |  |  |  |  |  |  |  |  |  |  ·  |  |  |  |  |  ●  |  |  |  |  |  |  |  |  |  
|  |  |  |  |  |  |  |  |  |  |  |  |  |  |  ·  |  |  |  |  |  ·  |  |  |  |  |  |  |  |  |  
|  |  |  |  |  |  |  |  |  |  |  |  |  |  |  ·  |  |  |  |  |  ·  |  |  |  |  |  |  |  |  |  
|  |  |  |  |  |  |  |  |  |  |  |  |  |  |  ·  |  |  |  |  |  ●  |  |  |  |  |  |  |  |  |  
|  |  |  |  |  |  |  |  |  |  |  |  |  |  |  ·  ·  ·  ·  ·  ·  ·  |  |  |  |  |  |  |  |  |  
|  |  |  |  |  |  |  |  |  |  |  |  |  |  |  |  |  |  |  |  |  |  |  |  |  |  |  |  |  |  |  
|  |  |  |  |  |  |  |  |  |  |  |  |  |  |  |  ·  ·  ·  ·  ·  ·  ·  |  |  |  |  |  |  |  |  
|  |  |  |  |  |  |  |  |  |  |  |  |  |  |  |  ·  |  |  |  |  |  ·  |  |  |  |  |  |  |  |  
|  |  |  |  |  |  |  |  |  |  |  |  |  |  |  |  ·  |  |  |  |  |  ·  |  |  |  |  |  |  |  |  
|  |  |  |  |  |  |  |  |  |  |  |  |  |  |  |  ·  |  |  |  |  |  ·  |  |  |  |  |  |  |  |  
|  |  |  |  |  |  |  |  |  |  |  |  |  |  |  |  ·  |  |  |  |  |  ·  |  |  |  |  |  |  |  |  
|  |  |  |  |  |  |  |  |  |  |  |  |  |  |  |  ·  |  |  |  |  |  ·  |  |  |  |  |  |  |  |  
|  |  |  |  |  |  |  |  |  |  |  |  |  |  |  |  ·  ·  ·  ·  ·  ·  ·  |  |  |  |  |  |  |  |  

|  |  |  |  |  |  |  |  |  |  |  |  |  |  |  |  |  |  |  |  |  |  |  |  |  |  |  |  |  |  |  
·  |  ·  ·  ·  ·  ·  ·  ·  |  ·  ·  ·  ·  ●  ·  ·  |  ·  |  ·  ·  ·  |  ·  ·  ·  ·  ·  ·  ·  
·  |  ·  |  |  |  ·  |  |  |  ·  |  |  |  ·  |  ·  |  ·  |  ·  |  ·  |  ·  |  |  |  |  |  ·  
·  ·  ·  |  ·  |  ·  |  ·  ·  ·  |  ·  ·  ·  |  ·  ·  ·  |  ·  |  ·  ·  ·  |  ·  ·  ·  |  ·  
·  |  |  |  ·  |  ·  |  ·  |  |  |  ·  |  ·  |  |  |  |  |  ·  |  |  |  |  |  ·  |  ·  |  ·  
·  ·  ·  ·  ·  |  ·  ·  ·  ·  ·  |  ·  |  ·  |  ●  ·  ·  |  ·  |  ·  ·  ·  ·  ●  |  ·  |  ·  
|  |  |  |  ·  |  |  |  |  |  |  |  ·  |  |  |  ·  |  ·  |  ·  |  |  |  |  |  ·  |  ·  |  ·  
·  ·  ·  ·  ·  |  ●  ·  ·  ·  ·  |  ·  |  ·  ·  ●  |  ·  ·  ·  |  ·  ·  ·  ·  ·  |  ·  |  ·  
·  |  |  |  |  |  ·  |  |  |  ·  |  ·  |  ·  |  |  |  |  |  |  |  ·  |  |  |  |  |  |  |  ·  
·  ·  ·  ·  ·  |  ·  ·  ·  |  ·  ·  ·  |  ·  |  ·  ·  ·  ·  ·  ·  ·  |  ·  ·  ·  |  ·  ·  ·  
|  |  |  |  ·  |  |  |  ·  |  |  |  ·  |  ·  |  ·  |  ·  |  ·  ·  ·  |  ·  |  ·  |  ·  |  |  
·  ·  ·  |  ·  |  ·  |  ·  ·  ·  |  ·  |  ·  ·  ·  |  ·  |  ●  ·  ·  |  ·  |  ·  |  ·  ·  ·  
|  |  ·  |  ·  |  ·  |  |  |  ·  |  |  |  |  |  |  |  ●  ·  ·  ·  |  |  ·  |  ·  |  ·  |  ·  
·  ·  ·  |  ·  ·  ·  |  ·  |  ·  ·  ·  ·  ·  ·  ·  ·  ·  ·  ·  ·  🟣 ·  ·  |  ·  |  ·  |  ·  
·  |  |  |  |  |  ·  |  ●  |  |  |  |  |  |  ·  |  |  |  |  ·  ·  |  |  |  |  ·  |  ●  |  ·  
·  ●  ·  |  ·  ●  ·  |  ·  ·  ·  ·  ·  ·  ·  ·  ·  |  ·  ·  ·  ·  ·  |  ·  ·  ·  |  ·  |  ·  
·  |  ·  |  ·  |  |  |  |  |  ·  |  |  |  |  ·  ●  |  ·  |  |  ·  ·  |  ·  |  |  |  |  |  ·  
·  |  ·  |  ·  ·  ·  |  ·  ·  ·  |  ·  |  ●  ·  ·  |  ·  |  ·  ·  ·  |  ·  ●  ·  ·  ·  |  ·  
|  |  ·  |  |  |  ·  |  ·  |  |  |  ·  |  ·  ·  |  |  ·  |  |  ●  ·  |  |  |  |  |  ·  |  ·  
·  ·  ·  ·  ·  |  ·  |  ·  ·  ·  |  ·  |  ·  ·  ·  ·  ·  ·  ·  ·  ·  |  ·  ·  ·  |  ·  ·  ·  
●  |  |  |  |  |  ·  |  ·  |  ●  |  ·  |  ·  |  |  |  |  |  ·  |  ·  |  |  |  ·  |  |  |  |  
·  ·  ·  ·  ·  ·  ·  |  ·  |  ·  |  ·  |  ·  |  ·  ·  ·  ·  ·  ·  ·  ·  ·  ·  ●  |  ·  ●  ·  
·  |  |  |  |  |  |  |  |  |  ·  |  ·  |  ●  |  ·  |  |  |  |  |  ·  |  |  |  ·  |  ·  |  ·  
·  ·  ·  ·  ·  |  ·  ·  ·  ·  ·  |  ·  |  ●  ·  ·  |  ·  ·  ·  ·  ·  ·  ·  |  ·  |  ·  |  ·  
|  |  |  |  ·  |  |  |  ·  |  |  |  ·  |  |  |  ·  |  ·  |  |  |  ·  |  ·  |  ·  |  ·  |  ·  
·  ·  ·  |  ·  ·  ·  ·  ·  |  ·  ·  ·  ●  ·  ·  ·  ·  ·  |  ·  ·  ·  |  ·  |  ·  |  ·  |  ·  
·  |  |  |  |  |  |  |  |  |  ●  |  |  |  |  |  ·  |  |  |  ·  |  ·  |  |  |  ·  |  ·  |  ·  
·  ·  ·  ·  ·  ·  ·  ·  ·  ·  ·  ·  ·  ·  ·  ●  ·  ·  ·  ·  ·  ·  ·  ·  ·  ·  ·  ·  ·  |  ·  

